
NO ./assets/textures/north.xpm
		C 			0,0,0

SO ./assets/textures/south.xpm

EA ./assets/textures/east.xpm

    F 255,255,255

WE           ./assets/textures/west.xpm

111111111111111111111111
100000000000000000000001
100011111100000111110001
100010000100000100010001
100010000100000100010001
100010000111111100010001
100010000000000000010001
100010000011111000010001
100010000010001000010001
100011111110001111110001
1000000000000000000000N1
111111111111111111111111